0,0,0,138,0,135,0,139,0,188,0,185,0,189,0,128,0,125,0,129,0,113,123,77
0,1,0,136,0,133,0,137,0,186,0,183,0,187,0,126,0,123,0,127,0,111,123,77
0,2,0,139,0,136,0,140,0,189,0,186,0,190,0,129,0,126,0,130,0,114,123,77
0,3,0,141,0,138,0,142,0,191,0,188,0,192,0,131,0,128,0,132,0,116,123,77
0,4,0,150,0,147,0,151,0,200,0,197,0,201,0,140,0,137,0,141,0,125,123,77
0,5,0,152,0,149,0,153,0,202,0,199,0,203,0,142,0,139,0,143,0,127,123,77
0,6,0,125,0,122,0,126,0,175,0,172,0,176,0,115,0,112,0,116,0,100,123,77
0,7,0,125,0,122,0,126,0,175,0,172,0,176,0,115,0,112,0,116,0,100,123,77
0,8,0,138,0,135,0,139,0,188,0,185,0,189,0,128,0,125,0,129,0,113,123,77
0,9,0,130,0,127,0,131,0,180,0,177,0,181,0,120,0,117,0,121,0,105,123,77
