0,48,0,52,0,36,123,77,0,43,0,61,0,58,0,62,0,12,0,12,0,24,0,51
0,48,0,52,0,36,123,77,0,44,0,61,0,58,0,62,0,48,0,48,0,96,0,51
0,48,0,52,0,36,123,77,0,45,0,61,0,58,0,62,0,84,0,84,0,168,0,51
0,48,0,52,0,36,123,77,0,46,0,61,0,58,0,62,0,120,0,120,0,240,0,51
0,48,0,52,0,36,123,77,0,47,0,61,0,58,0,62,0,156,0,156,0,56,0,51
0,48,0,52,0,36,123,77,0,48,0,61,0,58,0,62,0,192,0,192,0,128,0,51
0,48,0,52,0,36,123,77,0,49,0,61,0,58,0,62,0,228,0,228,0,200,0,51
0,48,0,52,0,36,123,77,0,50,0,61,0,58,0,62,0,8,0,8,0,16,0,51
0,48,0,52,0,36,123,77,0,51,0,61,0,58,0,62,0,44,0,44,0,88,0,51
0,48,0,52,0,36,123,77,0,52,0,61,0,58,0,62,0,80,0,80,0,160,0,51
0,48,0,52,0,36,123,77,0,53,0,61,0,58,0,62,0,116,0,116,0,232,0,51
0,48,0,52,0,36,123,77,0,54,0,61,0,58,0,62,0,152,0,152,0,48,0,51
0,48,0,52,0,36,123,77,0,55,0,61,0,58,0,62,0,188,0,188,0,120,0,51
0,48,0,52,0,36,123,77,0,56,0,61,0,58,0,62,0,224,0,224,0,192,0,51
0,48,0,52,0,36,123,77,0,57,0,61,0,58,0,62,0,4,0,4,0,8,0,51
0,48,0,52,0,36,123,77,0,58,0,61,0,58,0,62,0,40,0,40,0,80,0,51
0,48,0,52,0,36,123,77,0,59,0,61,0,58,0,62,0,76,0,76,0,152,0,51
0,48,0,52,0,36,123,77,0,60,0,61,0,58,0,62,0,112,0,112,0,224,0,51
0,48,0,52,0,36,123,77,0,61,0,61,0,58,0,62,0,148,0,148,0,40,0,51
0,48,0,52,0,36,123,77,0,62,0,61,0,58,0,62,0,184,0,184,0,112,0,51
0,48,0,52,0,36,123,77,0,63,0,61,0,58,0,62,0,220,0,220,0,184,0,51
0,48,0,52,0,36,123,77,0,64,0,61,0,58,0,62,0,0,0,0,0,0,0,51
0,48,0,52,0,36,123,77,0,24,0,24,0,48,0,51,0,48,0,52,0,36,123,77
0,23,0,61,0,58,0,62,0,60,0,60,0,120,0,51,0,48,0,52,0,36,123,77
0,24,0,61,0,58,0,62,0,96,0,96,0,192,0,51,0,48,0,52,0,36,123,77
0,25,0,61,0,58,0,62,0,132,0,132,0,8,0,51,0,48,0,52,0,36,123,77
0,26,0,61,0,58,0,62,0,168,0,168,0,80,0,51,0,48,0,52,0,36,123,77
0,27,0,61,0,58,0,62,0,204,0,204,0,152,0,51,0,48,0,52,0,36,123,77
0,28,0,61,0,58,0,62,0,240,0,240,0,224,0,51,0,48,0,52,0,36,123,77
0,29,0,61,0,58,0,62,0,20,0,20,0,40,0,51,0,48,0,52,0,36,123,77
0,30,0,61,0,58,0,62,0,56,0,56,0,112,0,51,0,48,0,52,0,36,123,77
0,31,0,61,0,58,0,62,0,92,0,92,0,184,0,51,0,48,0,52,0,36,123,77
0,32,0,61,0,58,0,62,0,128,0,128,0,0,0,51,0,48,0,52,0,36,123,77
0,33,0,61,0,58,0,62,0,164,0,164,0,72,0,51,0,48,0,52,0,36,123,77
0,34,0,61,0,58,0,62,0,200,0,200,0,144,0,51,0,48,0,52,0,36,123,77
0,35,0,61,0,58,0,62,0,236,0,236,0,216,0,51,0,48,0,52,0,36,123,77
0,36,0,61,0,58,0,62,0,16,0,16,0,32,0,51,0,48,0,52,0,36,123,77
0,37,0,61,0,58,0,62,0,52,0,52,0,104,0,51,0,48,0,52,0,36,123,77
0,38,0,61,0,58,0,62,0,88,0,88,0,176,0,51,0,48,0,52,0,36,123,77
0,39,0,61,0,58,0,62,0,124,0,124,0,248,0,51,0,48,0,52,0,36,123,77
0,40,0,61,0,58,0,62,0,160,0,160,0,64,0,51,0,48,0,52,0,36,123,77
0,41,0,61,0,58,0,62,0,196,0,196,0,136,0,51,0,48,0,52,0,36,123,77
0,42,0,61,0,58,0,62,0,232,0,232,0,208,0,65,0,48,0,52,0,36,123,77
0,43,0,61,0,58,0,62,0,12,0,12,0,24,0,51,0,48,0,52,0,36,123,77
0,44,0,61,0,58,0,62,0,48,0,48,0,96,0,51,0,48,0,52,0,36,123,77
0,45,0,61,0,58,0,62,0,84,0,84,0,168,0,51,0,48,0,52,0,36,123,77
0,46,0,61,0,58,0,62,0,120,0,120,0,240,0,51,0,48,0,52,0,36,123,77
0,47,0,61,0,58,0,62,0,156,0,156,0,56,0,51,0,48,0,52,0,36,123,77
0,48,0,61,0,58,0,62,0,192,0,192,0,128,0,51,0,48,0,52,0,36,123,77
0,49,0,61,0,58,0,62,0,228,0,228,0,200,0,51,0,48,0,52,0,36,123,77
0,50,0,61,0,58,0,62,0,8,0,8,0,16,0,51,0,48,0,52,0,36,123,77
0,51,0,61,0,58,0,62,0,44,0,44,0,88,0,51,0,48,0,52,0,36,123,77
0,52,0,61,0,58,0,62,0,80,0,80,0,160,0,51,0,48,0,52,0,36,123,77
0,53,0,61,0,58,0,62,0,116,0,116,0,232,0,51,0,48,0,52,0,36,123,77
0,54,0,61,0,58,0,62,0,152,0,152,0,48,0,51,0,48,0,52,0,36,123,77
0,55,0,61,0,58,0,62,0,188,0,188,0,120,0,51,0,48,0,52,0,36,123,77
0,56,0,61,0,58,0,62,0,224,0,224,0,192,0,51,0,48,0,52,0,36,123,77
0,57,0,61,0,58,0,62,0,4,0,4,0,8,0,51,0,48,0,52,0,36,123,77
0,58,0,61,0,58,0,62,0,40,0,40,0,80,0,51,0,48,0,52,0,36,123,77
0,59,0,61,0,58,0,62,0,76,0,76,0,152,0,51,0,48,0,52,0,36,123,77
0,60,0,61,0,58,0,62,0,112,0,112,0,224,0,51,0,48,0,52,0,36,123,77
0,61,0,61,0,58,0,62,0,148,0,148,0,40,0,51,0,48,0,52,0,36,123,77
0,62,0,61,0,58,0,62,0,184,0,184,0,112,0,51,0,48,0,52,0,36,123,77
0,63,0,61,0,58,0,62,0,220,0,220,0,184,0,51,0,48,0,52,0,36,123,77
0,64,0,61,0,58,0,62,0,0,0,0,0,0,0,51,0,48,0,52,0,36,123,77
