0,0,0,0,10,113,9,103,10,229,5,126,5,236,6,49,10,18,9,85,9,205,4,132,123,77
0,1,0,0,10,113,9,103,10,229,5,126,5,236,6,49,10,18,9,85,9,205,4,132,123,77
0,2,0,0,10,112,9,102,10,228,5,125,5,235,6,48,10,17,9,84,9,204,4,131,123,77
0,3,0,0,10,113,9,103,10,229,5,126,5,236,6,49,10,18,9,85,9,205,4,132,123,77
0,4,0,0,10,112,9,102,10,228,5,125,5,235,6,48,10,17,9,84,9,204,4,131,123,77
0,5,0,0,10,113,9,103,10,229,5,126,5,236,6,49,10,18,9,85,9,205,4,132,123,77
0,6,0,0,10,113,9,103,10,229,5,126,5,236,6,49,10,18,9,85,9,205,4,132,123,77
0,7,0,0,10,113,9,103,10,229,5,126,5,236,6,49,10,18,9,85,9,205,4,132,123,77
0,8,0,0,10,113,9,103,10,229,5,126,5,236,6,49,10,18,9,85,9,205,4,132,123,77
0,9,0,0,10,113,9,103,10,229,5,126,5,236,6,49,10,18,9,85,9,205,4,132,123,77
